                                        
                                        
                                        
                                        
                                        
            ####################        
       #####····················#       
      #············############·#       
      #············#          #·#       
      #············#          #·#       
      #············############·#       
      #····················@····#       
      #············####·········###     
      #······######   #············#    
       #####····#     #·········##·#    
           #····#     #·········##·#    
           #····#     #·········##·#    
    ########····#######·········##·#    
   #····························##·#    
   #············#######·········##·#    
   #············#     #············#    
   #············########···········#    
   #·······························#    
   #·········#·····#####···········#    
   #·······························#    
    #········#······················#   
     #########·····#####············#   
    ##########·····##···············#   
   #·········#·····##············#··#   
   #·········###### #·······###··#··#   
   #·········#   ####·······###··#··#   
   #·········#  #····················#  
   #·········####········######······#  
   #·····················#    #······#  
   #··········###·······#######······#  
   #·································#  
   #··········#################······#  
    #####·····#               #······#  
         #####                 ######   
                                        
